[
  {
    "name": "SWI",
    "time": 30,
    "difficulty": "EASY",
    "speed": 10,
    "gap": {
      "vertical": 7,
      "horizontal": 7
    },
    "brickHeight": 50,
    "colorByType": {
      "1": "#01a900",
      "2": "#00a8d5",
      "3": "#770000"
    },
    "col": 12,
    "row": 9,
    "data": [
      [0, 0, 0, 0, 0, 0, 0, 0, 0, 0, 0, 0],
      [0, 0, 0, 0, 0, 0, 0, 0, 0, 0, 0, 0],
      [0, 1, 1, 0, 0, 1, 0, 0, 0, 1, 0, 1],
      [1, 0, 0, 1, 0, 1, 0, 0, 0, 1, 0, 1],
      [1, 0, 0, 0, 0, 1, 0, 1, 0, 1, 0, 1],
      [0, 1, 0, 0, 0, 1, 0, 1, 0, 1, 0, 1],
      [0, 0, 1, 0, 0, 1, 0, 1, 0, 1, 0, 1],
      [0, 0, 0, 1, 0, 1, 0, 1, 0, 1, 0, 1],
      [1, 1, 1, 0, 0, 0, 1, 0, 1, 0, 0, 1]
    ]
  },
  {
    "name": "UMI",
    "time": 30,
    "difficulty": "EASY",
    "speed": 10,
    "gap": {
      "vertical": 7,
      "horizontal": 7
    },
    "brickHeight": 50,
    "colorByType": {
      "1": "#01a900",
      "2": "#00a8d5",
      "3": "#770000"
    },
    "col": 11,
    "row": 8,
    "data": [
      [0, 0, 0, 0, 0, 0, 0, 0, 0, 0, 0],
      [0, 0, 0, 0, 0, 0, 0, 0, 0, 0, 0],
      [1, 0, 1, 0, 1, 0, 0, 0, 1, 0, 1],
      [1, 0, 1, 0, 1, 1, 0, 1, 1, 0, 1],
      [1, 0, 1, 0, 1, 0, 1, 0, 1, 0, 1],
      [1, 0, 1, 0, 1, 0, 0, 0, 1, 0, 1],
      [1, 0, 1, 0, 1, 0, 0, 0, 1, 0, 1],
      [1, 1, 1, 0, 1, 0, 0, 0, 1, 0, 1]
    ]
  },
  {
    "name": "ZMP",
    "time": 30,
    "difficulty": "EASY",
    "speed": 10,
    "gap": {
      "vertical": 7,
      "horizontal": 7
    },
    "brickHeight": 40,
    "colorByType": {
      "1": "#01a900",
      "2": "#00a8d5",
      "3": "#770000"
    },
    "col": 14,
    "row": 8,
    "data": [
      [0, 0, 0, 0, 0, 0, 0, 0, 0, 0, 0, 0, 0, 0],
      [0, 0, 0, 0, 0, 0, 0, 0, 0, 0, 0, 0, 0, 0],
      [1, 1, 1, 1, 0, 1, 0, 0, 0, 1, 0, 1, 1, 1],
      [0, 0, 0, 1, 0, 1, 1, 0, 1, 1, 0, 1, 0, 1],
      [0, 0, 1, 0, 0, 1, 0, 1, 0, 1, 0, 1, 1, 1],
      [0, 1, 0, 0, 0, 1, 0, 0, 0, 1, 0, 1, 0, 0],
      [1, 0, 0, 0, 0, 1, 0, 0, 0, 1, 0, 1, 0, 0],
      [1, 1, 1, 1, 0, 1, 0, 0, 0, 1, 0, 1, 0, 0]
    ]
  },
  {
    "name": "DBS",
    "time": 30,
    "difficulty": "EASY",
    "speed": 10,
    "gap": {
      "vertical": 7,
      "horizontal": 7
    },
    "brickHeight": 50,
    "colorByType": {
      "1": "#01a900",
      "2": "#00a8d5",
      "3": "#770000"
    },
    "col": 13,
    "row": 8,
    "data": [
      [0, 0, 0, 0, 0, 0, 0, 0, 0, 0, 0, 0, 0],
      [1, 1, 0, 0, 1, 1, 0, 0, 0, 1, 1, 0, 0],
      [1, 0, 1, 0, 1, 0, 1, 0, 1, 0, 0, 1, 0],
      [1, 0, 1, 0, 1, 0, 1, 0, 1, 0, 0, 0, 0],
      [1, 0, 1, 0, 1, 1, 0, 0, 0, 1, 0, 0, 0],
      [1, 0, 1, 0, 1, 0, 1, 0, 0, 0, 1, 0, 0],
      [1, 0, 1, 0, 1, 0, 1, 0, 0, 0, 0, 1, 0],
      [1, 1, 0, 0, 1, 1, 0, 0, 1, 1, 1, 1, 0]
    ]
  },
  {
    "name": "OOP",
    "time": 30,
    "difficulty": "HARD",
    "speed": 15,
    "gap": {
      "vertical": 7,
      "horizontal": 7
    },
    "brickHeight": 40,
    "colorByType": {
      "1": "#01a900",
      "2": "#00a8d5",
      "3": "#770000"
    },
    "col": 15,
    "row": 10,
    "data": [
      [0, 0, 0, 0, 0, 0, 0, 0, 0, 0, 0, 0, 0, 0, 0],
      [0, 0, 0, 0, 0, 0, 0, 0, 0, 0, 0, 0, 0, 0, 0],
      [0, 3, 3, 3, 3, 0, 3, 3, 3, 3, 0, 3, 3, 3, 3],
      [0, 3, 0, 0, 3, 0, 3, 0, 0, 3, 0, 3, 0, 0, 3],
      [0, 3, 0, 0, 3, 0, 3, 0, 0, 3, 0, 3, 0, 0, 3],
      [0, 3, 0, 0, 3, 0, 3, 0, 0, 3, 0, 3, 0, 0, 3],
      [0, 3, 0, 0, 3, 0, 3, 0, 0, 3, 0, 3, 3, 3, 3],
      [0, 3, 0, 0, 3, 0, 3, 0, 0, 3, 0, 3, 0, 0, 0],
      [0, 3, 0, 0, 3, 0, 3, 0, 0, 3, 0, 3, 0, 0, 0],
      [0, 3, 3, 3, 3, 0, 3, 3, 3, 3, 0, 3, 0, 0, 0]
    ]
  },
  {
    "name": "AZA",
    "time": 30,
    "difficulty": "HARD",
    "speed": 15,
    "gap": {
      "vertical": 7,
      "horizontal": 7
    },
    "brickHeight": 40,
    "colorByType": {
      "1": "#01a900",
      "2": "#00a8d5",
      "3": "#770000"
    },
    "col": 15,
    "row": 10,
    "data": [
      [0, 0, 0, 0, 0, 0, 0, 0, 0, 0, 0, 0, 0, 0, 0],
      [0, 0, 0, 0, 0, 0, 0, 0, 0, 0, 0, 0, 0, 0, 0],
      [3, 3, 3, 3, 0, 3, 3, 3, 3, 3, 0, 3, 3, 3, 3],
      [3, 0, 0, 3, 0, 0, 0, 0, 0, 3, 0, 3, 0, 0, 3],
      [3, 0, 0, 3, 0, 0, 0, 0, 3, 0, 0, 3, 0, 0, 3],
      [3, 3, 3, 3, 0, 0, 0, 3, 0, 0, 0, 3, 3, 3, 3],
      [3, 0, 0, 3, 0, 0, 3, 0, 0, 0, 0, 3, 0, 0, 3],
      [3, 0, 0, 3, 0, 3, 0, 0, 0, 0, 0, 3, 0, 0, 3],
      [3, 0, 0, 3, 0, 3, 0, 0, 0, 0, 0, 3, 0, 0, 3],
      [3, 0, 0, 3, 0, 3, 3, 3, 3, 3, 0, 3, 0, 0, 3]
    ]
  },
  {
    "name": "MAT2",
    "time": 30,
    "difficulty": "HARD",
    "speed": 15,
    "gap": {
      "vertical": 7,
      "horizontal": 7
    },
    "brickHeight": 40,
    "colorByType": {
      "1": "#01a900",
      "2": "#00a8d5",
      "3": "#770000"
    },
    "col": 18,
    "row": 9,
    "data": [
      [0, 0, 0, 0, 0, 0, 0, 0, 0, 0, 0, 0, 0, 0, 0, 0, 0, 0],
      [0, 0, 0, 0, 0, 0, 0, 0, 0, 0, 0, 0, 0, 0, 0, 0, 0, 0],
      [3, 0, 0, 0, 3, 0, 3, 3, 3, 0, 3, 3, 3, 0, 3, 3, 3, 3],
      [3, 3, 0, 3, 3, 0, 3, 0, 3, 0, 0, 3, 0, 0, 0, 0, 0, 3],
      [3, 0, 3, 0, 3, 0, 3, 0, 3, 0, 0, 3, 0, 0, 0, 0, 3, 3],
      [3, 0, 0, 0, 3, 0, 3, 3, 3, 0, 0, 3, 0, 0, 0, 3, 0, 0],
      [3, 0, 0, 0, 3, 0, 3, 0, 3, 0, 0, 3, 0, 0, 3, 0, 0, 0],
      [3, 0, 0, 0, 3, 0, 3, 0, 3, 0, 0, 3, 0, 0, 3, 0, 0, 0],
      [3, 0, 0, 0, 3, 0, 3, 0, 3, 0, 0, 3, 0, 0, 3, 3, 3, 3]
    ]
  },
  {
    "name": "LA2",
    "time": 30,
    "difficulty": "HARD",
    "speed": 15,
    "gap": {
      "vertical": 7,
      "horizontal": 7
    },
    "brickHeight": 40,
    "colorByType": {
      "1": "#01a900",
      "2": "#00a8d5",
      "3": "#770000"
    },
    "col": 14,
    "row": 10,
    "data": [
      [0, 0, 0, 0, 0, 0, 0, 0, 0, 0, 0, 0, 0, 0],
      [0, 0, 0, 0, 0, 0, 0, 0, 0, 0, 0, 0, 0, 0],
      [3, 0, 0, 0, 0, 3, 3, 3, 3, 0, 3, 3, 3, 3],
      [3, 0, 0, 0, 0, 3, 0, 0, 3, 0, 0, 0, 0, 3],
      [3, 0, 0, 0, 0, 3, 0, 0, 3, 0, 0, 0, 0, 3],
      [3, 0, 0, 0, 0, 3, 3, 3, 3, 0, 0, 0, 3, 0],
      [3, 0, 0, 0, 0, 3, 0, 0, 3, 0, 0, 3, 0, 0],
      [3, 0, 0, 0, 0, 3, 0, 0, 3, 0, 3, 0, 0, 0],
      [3, 0, 0, 0, 0, 3, 0, 0, 3, 0, 3, 0, 0, 0],
      [3, 3, 3, 3, 0, 3, 0, 0, 3, 0, 3, 3, 3, 3]
    ]
  },
  {
    "name": "OS",
    "time": 500,
    "difficulty": "HARD",
    "speed": 25,
    "gap": {
      "vertical": 2,
      "horizontal": 2
    },
    "brickHeight": 40,
    "colorByType": {
      "1": "#01a900",
      "2": "#00a8d5",
      "3": "#770000"
    },
    "col": 16,
    "row": 13,
    "data": [
      [0, 0, 0, 0, 0, 0, 0, 0, 0, 0, 0, 0, 0, 0, 0, 0],
      [0, 0, 0, 0, 0, 0, 0, 0, 0, 0, 0, 0, 0, 0, 0, 0],
      [0, 0, 0, 4, 4, 4, 0, 0, 0, 0, 0, 4, 4, 4, 0, 0],
      [0, 0, 4, 4, 4, 4, 4, 0, 0, 0, 4, 4, 0, 4, 4, 0],
      [0, 4, 4, 0, 0, 0, 4, 4, 0, 4, 4, 0, 0, 0, 0, 0],
      [0, 4, 4, 0, 0, 0, 4, 4, 0, 4, 4, 0, 0, 0, 0, 0],
      [0, 4, 4, 0, 0, 0, 4, 4, 0, 0, 4, 4, 0, 0, 0, 0],
      [0, 4, 4, 0, 0, 0, 4, 4, 0, 0, 0, 4, 4, 0, 0, 0],
      [0, 4, 4, 0, 0, 0, 4, 4, 0, 0, 0, 0, 4, 4, 0, 0],
      [0, 4, 4, 0, 0, 0, 4, 4, 0, 0, 0, 0, 0, 4, 4, 0],
      [0, 0, 4, 4, 4, 4, 4, 0, 0, 4, 4, 0, 0, 4, 4, 0],
      [0, 0, 0, 4, 4, 4, 0, 0, 0, 0, 4, 4, 4, 4, 0, 0],
      [0, 0, 0, 0, 0, 0, 0, 0, 0, 0, 0, 0, 0, 0, 0, 0]
    ]
  }
]
